11111111t1111
100000000001
100000000001
111111e111111